#####################
S.....#.......#.....#
###.#.#.#.#.###.#.###
#...#...#.#...#.#.#.#
#######.###.#.###.#.#
#.........#.#.......#
#.###.#############.#
#...#.......#...#...#
#####.#####.#.#####.#
#.#.#.....#.#...#...#
#.#.#.#######.###.#.#
#...#.#.........#.#.#
###.#.###.#.#.#.###.#
#.......#.#.#.#.#.#.#
#.#.###.#.###.###.#.#
#.#...#.#.#.....#...#
#.###########.###.#.#
#.......#.....#...#.#
###.#.#####.#######.#
#...#.........#.....#
###################E#


