#####################
#...#...#...#.......#
###.#.###.#######.#.#
#...#.........#.#.#.#
#.#####.#####.#.#.#.#
#...#.....#.......#.#
#.###.#.###.###.###.#
#...#.#.#.....#.#...#
#.###.#######.###.#.#
#.....#...#.....#.#.#
#.#.#.#.###.#######.#
#E#.#.....#...#.....#
#####.#.###.#########
#.....#.#...#.#.....#
#.###########.###.###
#...#...#...#.#.#...#
#.#####.###.#.#.#.###
#.#.....#.........#S#
#.#####.#####.###.#.#
#...............#...#
#####################
