#################################################################################
#S#.......#.#.#.#.....#.#.....#...#.......#...#.#...#.....#.......#.............#
#.#.###.#.#.#.#.#####.#.#.#######.#.#####.#.#.#.#.#######.#####.###.#.#####.###.#
#.....#.#.....#...#.....#...#...#...#.#.....#...#...#.#...........#.#.#.#...#.#.#
###.###.#.#.###.#####.###.#####.#####.#.###.#####.#.#.###.###########.#.#.#.#.###
#.#.#.#.#.#...#.......#.....#.....#.....#.#.#.....#.#.#...............#...#.#...#
#.#.#.#######.#.#######.#.###.###.###.###.#####.#.###.###.###.###.#######.#.#.#.#
#.........#.......#.#.#.#...#.#.....#...........#.#...#.....#.#.......#.#.#...#.#
###.#.###.###.###.#.#.#.#########.#.###.#.#########.#.#.###########.###.###.#####
#...#...#.#...#.....#.....#.....#.#.#...#...#.......#...#.#.#...#.....#.#.#...#.#
#####.###############.#.#.###.###.#######.#.###.#####.#.#.#.#.###.###.#.#.#.#.#.#
#...#.#.....#.......#.#.#.#.......#.......#.....#...#.#.......#.#.#...#.....#...#
###.#.#.#######.#.###.#######.###.#####.###.#######.#.###.###.#.###########.###.#
#...........#...#.........#.#.#.#.#...#.#...#.....#...#...#.....#.#.....#.....#.#
###.#######.#############.#.#.#.#.###.#######.#####.#.#.#.###.###.###.#.###.###.#
#...#...#.#.#.....#.#...#...#...#.#...#.........#...#.#.#.#.......#...#.#.#.#...#
###.###.#.###.#.#.#.###.###.#.#.###.#########.###.#.#.#.#######.#.###.###.###.###
#.....#...#...#.#.#.#.....#...#.#.......#...#.....#.#.#...#.#...#.#...#.........#
#.###.#.#.#.#.###.#.#.#.###.###.#.#.###.#.###.#.#######.###.#####.#.#.#.#######.#
#.#.#.#.#.#.#.#.......#.......#...#...#...#.#.#.......#.#...#...#.#.#.......#...#
#.#.###.#.#.#.###.###.#######.#.###.#.#####.#####.#.###.###.#.#####.#####.###.###
#.#.....#...#...#.#.....#...#.#...#.#.......#...#.#.#.#.#.....#.....#...#.#.....#
#.###.#######.#.#.#.#.###.#.#.#######.###.#.#.#####.#.###.###.###.###.#.#####.#.#
#...#...#.#...#.#.#.#.#...#...#.#.#.....#.#.#.#.....#...#...#...#.#.#.#...#...#.#
###.#.###.#######.#########.###.#.#.#.#####.#.###.###.#.#######.###.###.#.#.###.#
#...#.#.#.......#.#.....#...#...#.#.#.#.......#.#.....#.#...#.#.......#.#.#.#.#.#
#.###.#.#.#######.#####.#######.#.#.###.#.###.#.###.###.###.#.#.###.#####.#.#.#.#
#...........#...#.#.....#...#...#.#...#.#.#...........#.....#...#...#.#...#...#.#
#.#.#.#######.#.#.#.###.#.#####.#.#.#.#.#######.#.###########.###.###.###.#.#####
#.#.#.....#...#...#...#.....#.......#.#.......#.#.....#.#...#.#.#...#.......#.#.#
#.###.###.###.###.#####.#####.#########.#.###.#.###.###.###.#.#.#.###.#######.#.#
#.#.#...#.#.#...#...#.#.......#...#.....#...#.#.#.....#...#.#.#.#.....#.#.......#
#.#.#######.#####.###.#######.#.#.###.#.#.###########.###.#.#.#.#.###.#.#.#.#.###
#.....#.#.#.#...........#.#.#.#.#.....#.#...#.#.#.........#...#.#.#...#.#.#.#...#
###.###.#.#.###.#######.#.#.#####.#.#####.###.#.###.#.#######.#.#.###.#.###.###.#
#...#.....#.....#.#.#.#...#.....#.#.#.#...#.....#...#.#.........#...#.......#...#
#.###.#######.###.#.#.#.#####.#.#####.#.###.###.#.#######.###.#######.#########.#
#...#...#.....#.#.....#.......#...#.....#.....#.#.....#.#...#...#...#.#.#.#.#...#
#.#####.###.###.#.###.#.###.#.###.#.#.###.#.###.#.#.###.#.###.###.#####.#.#.###.#
#.......#.......#...#...#...#.#...#.#.....#...#.#.#.#.......#...............#..E#
#################################################################################
