#####################################################################################################
#.......#.......#...........#.....#...#.#.......#.#.#.#...#.#.....#...#.#...#...#.#.........#.#...#.#
#.###.###.###.###.#.#####.###.#####.###.#.###.#.#.#.#.#.###.#.#.#.#.###.#.#####.#.###.#.#.#.#.###.#.#
#S#...#.....#...#.#...#.#...........#.....#...#.....#.......#.#.#.#.#.....#...#.#...#.#.#.#.#.......#
###.###.#####.#.#####.#.#.#.###.###.#.###.###.#####.###.#####.#####.#.###.###.#.#.#.###.###.#.###.###
#.#.......#.#.#.........#.#...#...#.#...#...#.#...#.#...#.....#.#...#...#.#.......#...#.#.....#.....#
#.###.#####.#.###.###################.#########.#######.###.#.#.#.#.#####.#.#.#####.#.#.#.###########
#...#.......#.#.#.....#...#.........#.......#.#.........#.#.#...#.#...#...#.#.....#.#.#.#.#.....#...#
###.#####.#####.#.#.#####.###.#####.#.#######.###.#####.#.#.#######.#.###.#.#.#########.###.#####.#.#
#.....#.#.....#...#...#.......#.....#...#...#.........#...#.#.......#.#...#.#.....#.......#.#.....#.#
#.#.###.#.#######.#.#.###.#########.#.#.###.#.#####.#.###.#.#.#.#.###.###.###.#########.###.#.#.#.#.#
#.#.........#.....#.#.......#.....#...#...#.....#...#...#...#.#.#.#.#.#.........#.....#.....#.#.#.#.#
#####.###.###.###.#.#######.#.#.###.###########.#####.#############.#.#.#############.#.###########.#
#...#...#.#...#.#.#.......#...#.#...#.......#...#.#.....#.#.....#.#...........#.....#.#...#...#.....#
#.#.###########.#######.###.#.###.#####.###.#.###.###.#.#.#.###.#.###.#####.#.#.#.#.#.###.###.#####.#
#.#...#.#.#.#.#.#.......#.#.#...#.......#...#.#.......#.#.#...#.#.....#...#.#...#.#...#.......#.....#
#.###.#.#.#.#.#.#####.###.#.###.###########.###.#.#####.#.###.#.#.#.#.#.#.###.#######.#.#.#.###.###.#
#...#.#.#.........#.#.#.......#...#.........#.#.#...#.#...#...#.#.#.#...#...#.....#...#.#.#.#.#...#.#
#.###.#.#.#.#.###.#.#.#####.#######.#####.#.#.#####.#.#####.#.###.###.#####.###########.#####.#####.#
#.#.#...#.#.#.#.....#.#...#.#.#.#...#.....#.#.#.........#.#.#.#.....#...#.#...#...#...............#.#
#.#.#############.###.###.###.#.###########.#.###.###.#.#.###.###.###.###.#######.#####.###.#####.#.#
#.#.....#.#.#.....#...#.....#.......#.......#.#.#...#.#.........#.#...........#...#.#...#...#.......#
#.#.#####.#.###.#.#.#.#.#####.###.###.#######.#.#.###.###.#.#.#########.###.#.#.###.#######.#####.###
#.....#...#.#...#...#...#...#.#...#.#.#...#.........#...#.#.#...#.......#.#.#.#...#...#...#.#.....#.#
###.###.###.#######.#.#####.###.###.###.#.###.#############.#.###.###.#.#.###.###.#.#####.#####.#.#.#
#...#...#.....#...#.#...#...#.#.......#.#.#.....#...#.....#.#.#.#.#...#...#...#.#.#.#.......#.#.#.#.#
###.#.###.#######.#####.###.#.#.###.#####.#.#.###.#######.###.#.#.#########.###.#.#.#.###.#.#.###.#.#
#.....#.#.........#.......#...#.#...#.....#.#...#...#...#...#.#...#.....#.#...#...#.....#.#.....#...#
#.###.#.###.#####.###.#####.#.#.#.#####.#####.#.###.###.#.#######.#####.#.###.###.#.###.#.#########.#
#.#...........#.......#...#.#...#.#.......#...#.#.......#...#.......#...#...#...#.#...#.#.........#.#
#####.#####.#####.#####.###.#####.#######.###.###.#####.#.#########.###.###.###.#.#.###.#####.#####.#
#...#.#.......#...#.#.......#.#...#.#.......#.....#.#...#.#...#...#...#.#...#.....#.#...#.#.#...#...#
#.###############.#.#.###.#.#.###.#.###.#####.###.#.#.#.#.###.###.#.#.#.###.###########.#.#.###.#.###
#...#.....#.............#.#...#.................#.#...#.....#.....#.#.#.#.#.............#...........#
#.#.#####.#.###########.###.#####.#######.###.###.#.#####.#.#.#######.#.#.#.#.#.#########.#.###.###.#
#.#...#.#...........#...#.#.#...#.....#.#...#...#.#.#...#.#.......#.........#.#.#.....#...#...#.#.#.#
#####.#.###.###########.#.#.#.###.###.#.#.#######.###.###.###.#.#####.#.#.###.###.#.#.#.#####.###.###
#.......#.#.#.....#.......#.#.....#.....#.......#...#.#...#.#.#.......#.#...#.#...#.#.....#.......#.#
#####.#.#.#.###.#####.#.###.#####.#####.#.###.#.#####.###.#.###.#.###.###.#########.###.#########.#.#
#.....#.............#.#.#.....#.....#...#.#...#.........#...#...#...#...#.#E..........#.#...........#
#####################################################################################################
